W,W,W,W,W,W,W,W,W,W
W,W,W,#,M,#,#,#,#,W
W,W,W,#,L,#,#,#,#,W
W,W,W,#,#,#,#,#,#,W
W,W,W,#,#,#,#,#,#,E
W,W,W,#,M,#,#,#,#,W
W,W,W,#,#,#,#,L,#,W
W,W,W,#,#,#,L,M,#,W
W,W,W,#,#,#,#,#,#,W
W,W,W,W,W,W,W,W,W,W
