W,W,W,W,E,W,W,W,W,W
W,L,#,#,#,#,#,#,#,W
W,#,#,M,L,#,#,M,#,W
W,#,#,#,#,M,#,#,#,W
W,#,#,#,#,#,#,#,#,W
W,#,#,L,U,#,#,#,#,W
W,W,W,W,W,W,W,W,W,W
#,#,#,#,#,#,#,#,#,#
#,#,#,#,#,#,#,#,#,#
#,#,#,#,#,#,#,#,#,#