#,#,#,W,W,W,W,W,W,W
#,#,#,W,M,#,#,#,#,W
#,#,#,W,L,#,#,#,#,W
#,#,#,W,#,#,#,#,#,W
#,#,#,W,#,#,#,#,#,E
#,#,#,W,M,#,#,#,#,W
#,#,#,W,#,#,#,L,#,W
#,#,#,W,#,#,L,M,#,W
#,#,#,W,#,#,#,#,#,W
#,#,#,W,W,W,W,W,W,W
