W,W,W,W,E,W,W,W,W,W
W,#,#,#,#,#,#,#,#,W
W,#,#,#,L,#,#,#,#,W
W,#,L,#,#,M,#,#,#,W
E,D,M,#,#,#,#,#,#,W
W,#,#,#,#,#,#,M,#,W
W,#,#,#,#,#,#,#,#,W
W,#,#,L,#,#,#,#,#,W
W,#,#,#,#,#,#,#,#,W
W,W,W,W,E,W,W,W,W,W