W,W,W,W,W,W,W,W,W,W
W,W,W,W,W,W,W,W,W,W
W,W,W,W,W,W,W,W,W,W
W,#,#,#,#,#,#,#,#,W
W,#,#,L,#,#,#,#,#,W
W,#,#,M,#,#,L,#,#,W
W,#,#,#,#,#,#,#,#,W
W,#,M,#,#,#,#,#,#,W
W,#,#,#,#,M,#,#,#,W
W,W,W,W,E,W,W,W,W,W
