W,W,W,W,W,W,W,#,#,#
W,#,#,#,#,M,W,#,#,#
W,#,L,#,#,#,W,#,#,#
W,#,#,M,#,#,W,#,#,#
E,#,#,#,#,#,W,#,#,#
W,#,M,#,#,#,W,#,#,#
W,#,#,#,#,L,W,#,#,#
W,#,#,L,#,#,W,#,#,#
W,#,#,#,#,#,W,#,#,#
W,W,W,W,W,W,W,#,#,#
