W,W,W,W,E,W,W,W,W,W
W,#,#,#,#,#,#,#,#,W
W,#,#,#,#,#,#,#,#,W
W,#,#,#,#,#,#,#,#,W
W,#,#,#,#,U,#,#,#,E
W,#,#,#,#,#,#,#,#,W
W,#,#,#,#,#,#,#,#,W
W,#,#,#,#,#,#,#,#,W
W,#,#,#,#,#,#,#,#,W
W,W,W,W,W,W,W,W,W,W
