W,W,W,W,E,W,W,W,W,W
W,#,#,#,#,#,#,#,#,W
W,#,#,#,L,#,#,#,#,W
W,#,#,#,#,M,#,#,#,W
W,#,#,#,#,#,#,#,#,E
W,#,#,#,#,#,#,#,#,W
W,#,#,#,#,#,#,#,#,W
W,#,#,#,#,#,#,#,#,W
W,#,#,#,#,#,#,#,#,W
W,W,W,W,E,W,W,W,W,W