W,W,W,E,W,W,W,#,#,#
W,#,#,#,#,L,W,#,#,#
W,#,M,#,#,#,W,#,#,#
W,#,#,L,M,#,W,#,#,#
W,#,#,#,#,#,W,#,#,#
W,#,L,#,#,#,W,#,#,#
W,#,#,M,L,#,W,#,#,#
W,M,#,#,#,#,W,#,#,#
W,#,#,#,#,#,W,#,#,#
W,W,W,E,W,W,W,#,#,#
