W,W,W,W,W,W,W,W,W,W
W,#,L,#,#,#,#,#,#,W
W,M,#,#,L,#,#,L,#,W
E,#,#,#,#,M,#,#,#,E
W,#,#,#,#,#,#,M,#,W
W,#,M,#,#,#,L,#,#,W
W,W,W,W,W,W,W,W,W,W
#,#,#,#,#,#,#,#,#,#
#,#,#,#,#,#,#,#,#,#
#,#,#,#,#,#,#,#,#,#
