W,W,W,W,W,W,W,W,W,W
W,#,#,#,L,#,#,#,#,W
W,#,#,#,#,#,#,#,#,W
W,#,#,#,#,#,#,#,#,W
W,#,#,#,M,#,#,M,#,W
E,M,#,M,D,M,#,#,#,W
W,#,#,#,M,#,#,#,#,W
W,#,#,#,#,#,#,#,#,W
W,#,#,#,#,#,#,#,#,W
W,W,W,W,W,W,W,W,W,W