W,W,W,W,W,W,E,W,W,W
W,#,#,#,#,#,#,#,#,W
W,#,#,#,#,#,M,#,#,W
W,#,#,#,#,#,#,#,#,E
W,#,#,#,#,#,#,#,#,W
W,#,#,L,#,#,#,#,#,W
W,#,#,#,#,#,#,#,#,W
W,#,#,#,#,#,#,#,#,W
W,#,#,#,#,#,#,#,D,W
W,W,W,W,W,W,W,W,W,W