W,W,W,W,W,W,W,W,W,W
W,#,#,#,#,#,#,#,#,W
W,#,#,#,L,#,#,#,#,W
W,#,#,#,#,M,#,#,#,W
W,#,#,#,#,#,#,#,#,E
W,D,#,#,#,#,#,#,#,W
W,#,#,#,#,L,#,#,#,W
W,#,#,#,#,#,#,#,#,W
W,#,#,#,M,#,#,#,#,W
W,W,W,W,W,W,W,W,W,W
