W,W,W,W,W,E,W,W,W,W
W,#,#,#,#,#,#,#,#,W
W,#,#,#,#,#,M,#,#,W
W,#,#,#,#,#,#,#,#,W
W,#,#,#,#,#,#,#,#,W
W,#,#,L,#,#,#,#,#,E
W,#,#,#,#,#,#,#,#,W
W,#,#,#,#,#,#,#,#,W
W,#,#,#,#,#,#,#,D,W
W,W,W,W,W,W,W,W,W,W