W,W,W,W,E,W,W,W,W,W
W,#,#,#,M,#,#,#,#,W
W,#,#,#,L,#,#,#,#,W
W,#,#,#,#,M,#,#,#,W
E,#,#,M,#,#,#,#,#,W
W,#,#,#,#,#,#,L,#,W
W,#,#,#,#,#,#,#,#,W
W,#,#,#,#,L,#,#,#,W
W,#,#,#,#,#,#,#,#,W
W,W,W,W,W,W,W,W,W,W