W,W,W,W,W,W,W,W,W,W
W,#,#,#,#,#,M,W,W,W
W,#,L,#,#,#,#,W,W,W
W,#,#,M,#,#,#,W,W,W
E,#,#,#,#,#,#,w,W,W
W,#,M,#,#,#,#,W,W,W
W,#,#,#,#,#,L,W,W,W
W,#,#,L,#,#,#,W,W,W
W,#,#,#,#,#,#,W,W,W
W,W,W,W,W,W,W,W,W,W
