W,W,W,W,W,W,W,W,W,W
W,#,#,#,#,#,#,#,#,W
W,#,#,#,L,#,#,#,#,W
W,#,#,#,#,M,#,#,#,W
E,#,#,#,#,#,#,#,#,E
W,#,#,#,#,#,#,#,#,W
W,#,M,#,#,#,#,M,#,W
W,#,#,#,L,#,#,L,#,W
W,#,#,#,#,#,#,#,#,W
W,W,W,W,E,W,W,W,W,W