W,W,W,W,E,W,W,W,W,W
W,#,#,#,M,#,#,#,#,W
W,#,#,#,L,#,#,#,#,W
W,#,#,#,#,M,#,#,#,W
E,#,#,#,#,#,#,#,M,E
W,#,#,#,#,#,#,#,#,W
W,#,#,#,#,#,#,#,#,W
W,#,#,L,#,#,#,L,#,W
W,#,#,#,#,#,#,#,#,W
W,W,W,W,W,W,W,W,W,W