W,W,W,W,E,W,W,W,W,W
W,#,#,#,#,#,#,#,#,W
W,#,#,#,L,#,#,#,#,W
W,#,M,#,#,M,#,#,#,W
W,#,#,#,#,#,#,L,#,E
W,#,#,#,#,#,#,#,#,W
W,#,M,#,#,#,#,#,#,W
W,#,#,#,#,L,#,#,#,W
W,#,#,#,#,#,#,#,#,W
W,W,W,W,W,W,W,W,W,W