W,W,W,W,E,W,W,W,W,W
W,#,#,#,#,#,#,#,#,W
W,#,#,M,L,#,#,#,#,W
W,#,#,#,#,M,#,#,#,W
W,#,#,#,#,#,#,#,#,W
W,#,#,L,#,#,#,#,#,W
W,#,#,#,U,#,M,#,L,W
W,W,W,W,W,W,W,W,w,W
W,W,W,W,W,W,W,W,W,W
W,W,W,W,W,W,W,W,W,W