W,W,W,W,W,W,W,W,W,W
W,#,#,#,#,#,#,#,#,W
W,#,#,#,L,#,#,#,#,W
W,#,#,#,#,M,#,#,#,W
W,#,L,#,#,#,#,#,W,W
W,#,#,#,#,#,#,W,#,E
W,#,L,#,#,#,W,#,#,W
W,M,#,#,#,W,#,#,W,#
W,#,#,#,W,#,#,W,#,#
W,W,W,W,W,E,W,#,#,#