W,W,W,W,E,W,W,W,W,W
W,#,#,#,#,#,#,#,#,W
W,#,#,#,#,#,#,#,#,W
W,#,#,#,#,#,M,#,#,W
E,#,#,#,#,U,#,#,#,W
W,#,#,#,#,#,#,#,#,W
W,#,#,#,#,#,#,#,#,W
W,#,#,#,#,L,#,#,#,W
W,#,#,#,#,#,#,#,#,W
W,W,W,W,W,W,W,W,W,W
