W,W,W,W,W,W,W,W,W,W
W,#,#,#,#,#,#,M,#,W
W,#,#,#,L,#,#,#,#,W
W,#,#,#,#,M,#,#,#,W
E,#,M,#,#,U,#,#,#,W
W,#,#,#,#,#,#,L,#,W
W,#,#,L,#,#,#,#,#,W
W,#,#,#,#,#,L,#,#,W
W,#,#,#,#,M,#,M,#,W
W,W,W,W,E,W,W,W,W,W