#,#,#,#,#,#,#,#,#,#
#,#,#,#,#,#,#,#,#,#
#,#,#,#,#,#,#,#,#,#
W,W,W,W,W,W,W,W,W,W
W,#,M,#,#,l,#,#,#,W
W,#,#,#,#,#,#,L,#,W
E,#,M,#,L,#,#,#,#,E
W,#,#,#,#,#,#,M,#,W
W,M,#,#,#,#,#,#,L,W
W,W,W,W,E,W,W,W,W,W