W,W,W,W,W,W,W,W,W,W
W,#,#,#,L,#,#,#,#,W
W,#,M,#,#,#,#,#,#,W
W,#,#,#,#,#,M,#,#,W
W,#,L,#,#,U,#,M,#,W
W,#,#,#,#,#,#,#,#,W
W,#,#,#,#,#,L,#,#,E
W,#,M,L,#,#,#,#,#,W
W,#,#,#,#,#,#,#,#,W
W,W,W,W,W,W,E,W,W,W