#,#,#,#,#,#,#,#,#,#
#,#,#,#,#,#,#,#,#,#
#,#,#,#,#,#,#,#,#,#
W,W,W,W,W,W,W,W,W,W
W,#,#,#,#,#,#,#,M,W
W,#,#,L,#,#,#,#,L,W
E,#,#,#,M,#,L,#,#,E
W,#,#,L,#,#,M,#,#,W
W,#,#,#,#,#,#,#,#,W
W,W,W,W,W,W,W,W,W,W