#,#,#,#,#,#,#,#,#,#
#,#,#,#,#,#,#,#,#,#
#,#,#,#,#,#,#,#,#,#
W,W,W,W,W,W,W,W,W,W
W,L,#,#,#,#,M,#,M,W
W,#,#,#,#,#,#,#,L,W
E,#,#,#,M,#,#,#,#,E
W,#,#,L,#,#,M,L,#,W
W,#,#,#,#,#,#,#,#,W
W,W,W,W,W,W,W,W,W,W