#,#,#,W,W,W,E,W,W,W
#,#,#,W,#,#,#,#,M,W
#,#,#,W,#,#,M,#,#,W
#,#,#,W,M,#,#,#,#,W
#,#,#,W,#,#,#,L,#,W
#,#,#,W,#,L,#,#,#,W
#,#,#,W,#,#,#,#,#,W
#,#,#,W,#,L,#,#,L,W
#,#,#,W,#,#,#,M,#,W
#,#,#,W,W,W,E,W,W,W
