W,W,W,W,E,W,W,W,W,W
W,#,#,M,#,#,#,#,L,W
W,#,#,#,L,#,#,#,#,W
E,#,M,#,#,M,#,#,#,E
W,#,L,#,#,#,#,L,#,W
W,#,#,#,D,#,M,#,#,W
W,W,W,W,W,W,W,W,W,W
#,#,#,#,#,#,#,#,#,#
#,#,#,#,#,#,#,#,#,#
#,#,#,#,#,#,#,#,#,#
