W,W,W,W,W,W,W,W,W,W
W,#,#,#,#,#,#,#,#,W
W,#,#,#,#,#,#,#,#,W
W,#,#,#,#,#,M,#,#,W
W,#,#,#,#,#,#,#,#,W
W,#,#,#,D,#,#,#,#,W
W,#,#,#,#,#,#,#,#,W
W,#,#,#,#,L,#,#,#,W
W,#,#,#,#,#,#,#,#,W
W,W,W,W,W,W,W,W,W,W
