W,W,W,W,E,W,W,W,W,W
W,#,#,#,#,#,#,#,#,W
W,#,#,#,#,#,#,#,#,W
W,#,#,M,#,#,#,#,#,W
E,#,#,#,#,#,#,#,#,E
W,#,#,#,#,#,#,#,#,W
W,#,#,#,#,#,L,#,#,W
W,#,#,#,#,#,#,#,#,W
W,#,#,#,#,#,#,#,#,W
W,W,W,W,W,W,W,W,W,W
